#Please keep tags sorted on alphabetical use when you add/remove country tags

#Special countries..
REB="countries/rebels.txt"
PIR="countries/pirates.txt"
NAT="countries/natives.txt"

#Scandinavia
SWE="countries/Sweden.txt"
DAN="countries/Denmark.txt"
FIN="countries/Finland.txt"
GOT="countries/Gotland.txt"
NOR="countries/Norway.txt"
SHL="countries/Holstein.txt"
SCA="countries/Scandinavia.txt"

#Balkans
ACH="countries/PrincipalityOfAchaia.txt"
ALB="countries/Albania.txt"
ATH="countries/Athens.txt"
BOS="countries/Bosnia.txt"
BUL="countries/Bulgaria.txt"
BYZ="countries/ByzantineEmpire.txt"
CEP="countries/Corfu.txt"
CRO="countries/Croatia.txt"
CRT="countries/Crete.txt"
CYP="countries/Cyprus.txt"
GRE="countries/Greece.txt"
KNI="countries/Knights.txt"
MOE="countries/Morea.txt"
MOL="countries/Moldavia.txt"
MON="countries/Montenegro.txt"
NAX="countries/Naxos.txt"
RAG="countries/Ragusa.txt"
SER="countries/Serbia.txt"
TRA="countries/Transylvania.txt"
WAL="countries/Wallachia.txt"
HUN="countries/Hungary.txt"
TUR="countries/Ottomans.txt"

#British Isles 
CNN="countries/Connacht.txt"
CRN="countries/Cornwall.txt"
ENG="countries/England.txt"
LEI="countries/Leinster.txt"
IRE="countries/Ireland.txt"
LAN="countries/Lancaster.txt"
MNS="countries/Munster2.txt"
SCO="countries/Scotland.txt"
TYR="countries/Tyrone.txt"
WLS="countries/Wales.txt"
YOR="countries/York.txt"
NOL="countries/Northumberland.txt"
GBR="countries/GreatBritain.txt"

#Colonies
BRZ="countries/Brazil.txt"
CAN="countries/Canada.txt"
CHL="countries/Chile.txt"
COL="countries/Colombia.txt"
HAT="countries/Haiti.txt"
LAP="countries/LaPlata.txt"
LOU="countries/Louisiana.txt"
MEX="countries/Mexico.txt"
PEU="countries/Peru.txt"
PRG="countries/Paraguay.txt"
QUE="countries/Quebec.txt"
CAM="countries/UPCA.txt"
USA="countries/USA.txt"
VNZ="countries/Venezuela.txt"

#Eastern Europe
DNZ="countries/Danzig.txt"
KRA="countries/Krakow.txt"
LIT="countries/Lithuania.txt"
LIV="countries/LivonianOrder.txt"
MAZ="countries/Mazovia.txt"
POL="countries/Poland.txt"
PRU="countries/Prussia.txt"
KUR="countries/Kurland.txt"
RIG="countries/Riga.txt"
TEU="countries/teutonicOrder.txt"
	
#France 
ALE="countries/Alencon.txt"
ALS="countries/Alsace.txt"
AMG="countries/Armagnac.txt"
AUV="countries/Auvergne.txt"
AVI="countries/Avignon.txt"
BOU="countries/Bourbonnais.txt"
BRI="countries/Brittany.txt"
BUR="countries/Burgundy.txt"
CHP="countries/Champagne.txt"
COR="countries/Corsica.txt"
DAU="countries/Dauphine.txt"
FOI="countries/Foix.txt"
FRA="countries/France.txt"
GUY="countries/Guyenne.txt"
NEV="countries/Nevers.txt"
NRM="countries/Normandy.txt"
ORL="countries/Orleans.txt"
PRO="countries/Provence.txt"
RFR="countries/FrenchRepublic.txt"
SPI="countries/SardiniaPiedmont.txt"
TOU="countries/Toulouse.txt"
BER="countries/Berry.txt"
	
#HRE
AAC="countries/Aachen.txt" 
ANH="countries/Anhalt.txt"
ANS="countries/Ansbach.txt"
AUG="countries/Augsburg.txt"
BAD="countries/Baden.txt"
BAV="countries/Bavaria.txt"
BOH="countries/Bohemia.txt"
BRA="countries/Brandenburg.txt"
BRE="countries/Bremen.txt"
BRU="countries/Brunswick.txt"
FRN="countries/Frankfurt.txt"
GER="countries/Germany.txt"
HAB="countries/Austria.txt"
HAM="countries/Hamburg.txt"
HAN="countries/Hannover.txt"
HES="countries/Hessen.txt"
HRE="countries/HolyRomanEmpire.txt"
KLE="countries/Kleves.txt"
KOL="countries/Cologne.txt"
LAU="countries/Lauenburg.txt"
LOR="countries/Lorraine.txt"
LUN="countries/Luneburg.txt"
MAG="countries/Magdeburg.txt"
MAI="countries/Mainz.txt"
MEI="countries/Meissen.txt"
MKL="countries/Mecklenburg.txt"
MUN="countries/Munster.txt"
OLD="countries/Oldenburg.txt"
PAL="countries/Palatinate.txt"
POM="countries/Pommerania.txt"
SAX="countries/Saxony.txt"
SIL="countries/Silesia.txt"
SLZ="countries/Salzburg.txt"
STY="countries/Styria.txt"
SWI="countries/Schweiz.txt"
THU="countries/Thuringia.txt"
TIR="countries/Tirol.txt"
TRI="countries/Trier.txt"
ULM="countries/Ulm.txt"
WBG="countries/Wurzburg.txt"
WES="countries/Westfalia.txt"
WUR="countries/Wurttemberg.txt"
	
#Spain
ARA="countries/Aragon.txt"
CAS="countries/Castille.txt"
CAT="countries/Catalunya.txt"
GRA="countries/Granada.txt"
NAV="countries/Navarra.txt"
POR="countries/Portugal.txt"
SPA="countries/Spain.txt"
GAL="countries/Galicia.txt"
	
#Italy
AQU="countries/Aquileia.txt"
ETR="countries/Etruria.txt"
FER="countries/Ferrara.txt"
GEN="countries/Genoa.txt"
ITA="countries/Italy.txt"
MAN="countries/Mantua.txt"
MLO="countries/Milan.txt"
MOD="countries/Modena.txt"
NAP="countries/Naples.txt"
PAP="countries/PapalStates.txt"
PAR="countries/Parma.txt"
PIS="countries/Pisa.txt"
SAR="countries/Sardinia.txt"
SAV="countries/Savoy.txt"
SIC="countries/Sicily.txt"
SIE="countries/Siena.txt"
TUS="countries/Tuscany.txt"
URB="countries/Urbino.txt"
VEN="countries/Venice.txt"
	
#Low Countries
BRB="countries/Brabant.txt"
FLA="countries/Flanders.txt"
FRI="countries/Friesland.txt"
GEL="countries/Gelre.txt"
HAI="countries/Hainaut.txt"
HOL="countries/Holland.txt"
LIE="countries/Liege.txt"
LUX="countries/Luxembourg.txt"
NED="countries/Netherlands.txt"
UTR="countries/Utrecht.txt"

#Russia 
ARM="countries/Armenia.txt"
AST="countries/Astrakhan.txt"
CRI="countries/Crimea.txt"
GEO="countries/Georgia.txt"
GOL="countries/GoldenHorde.txt"
KAZ="countries/Kazan.txt"
MOS="countries/Muscowy.txt"
NOV="countries/Novgorod.txt"
PSK="countries/Pskov.txt"
QAS="countries/QasimKhanate.txt"
RUS="countries/Russia.txt"
RYA="countries/Ryazan.txt"
TVE="countries/Tver.txt"
UKR="countries/Ukraine.txt"
YAR="countries/Yaroslavl.txt"
ZAZ="countries/Zaporozhie.txt"
NOG="countries/Nogai.txt"
SIB="countries/Sibir.txt"
PLT="countries/Polotsk.txt"	

#Arabia	
ADE="countries/Yemen.txt"
ALH="countries/Haasa.txt"
OMA="countries/Oman.txt"
NAJ="countries/Najd.txt"
HED="countries/Hedjaz.txt"
SHR="countries/Sharjah.txt"

#Asia Minor		
AKK="countries/AkKoyunlu.txt"
AYD="countries/Aydin.txt"
CND="countries/Candar.txt"
DUL="countries/Dulkadir.txt"
IRQ="countries/Iraq.txt"
KAR="countries/Karaman.txt"
SYR="countries/Syria.txt"
TRE="countries/Trebizond.txt"
SRU="countries/Saruhan.txt"
MEN="countries/Mentese.txt"
RAM="countries/Ramazan.txt"
	
#Maghreb
ALG="countries/Algiers.txt"
FEZ="countries/Fez.txt"
MAM="countries/Burgi.txt"
MOR="countries/Morocco.txt"
TRP="countries/Tripoli.txt"
TUN="countries/Tunisia.txt"
	
#Central Asia
KZH="countries/Kazakh.txt"
KHI="countries/Khiva.txt"
SHY="countries/Shaybanid.txt"
KOK="countries/Kokkand.txt"

#Persia	
DUR="countries/Durrani.txt"
KHO="countries/Khorasan.txt"
JAI="countries/Jalayirid.txt"
PER="countries/Persia.txt"
QAR="countries/QaraKoyunlu.txt"
TIM="countries/Timurid.txt"

#Americas:	
AZT="countries/Aztec.txt"
CHE="countries/Cherokee.txt"
CHM="countries/Chimu.txt"
CRE="countries/Creek.txt"
HUR="countries/Huron.txt"
INC="countries/Inca.txt"
IRO="countries/Iroquois.txt"
MAY="countries/Maya.txt"
SHA="countries/Shawnee.txt"
ZAP="countries/Zapotec.txt"

#Africa:
ASH="countries/Ashanti.txt"
BEN="countries/Benin.txt"
ETH="countries/Ethiopia.txt"
KON="countries/Kongo.txt"
MAL="countries/Mali.txt"
NUB="countries/Funj.txt"
SON="countries/Songhai.txt"
ZAN="countries/Swahili.txt"
ZIM="countries/Mutapa.txt"
ADA="countries/Adal.txt"
HAU="countries/Hausa.txt"
KBO="countries/KanemBornu.txt"
LOA="countries/Loango.txt"
OYO="countries/Oyo.txt"
SOF="countries/Sofala.txt"
SOK="countries/Sokoto.txt"

#Far East
ANN="countries/Annam.txt"
ARK="countries/Arakan.txt"
ATJ="countries/Atjeh.txt"
AYU="countries/Ayutthaya.txt"
BLI="countries/Bali.txt"
BAN="countries/Banten.txt"
BEI="countries/Brunei.txt"
CHA="countries/Champa.txt"
CHG="countries/ChagataiKhanate.txt"
CHK="countries/Champassak.txt"
DAI="countries/DaiViet.txt"
JAP="countries/Japan.txt"

#Daimyos
MIN="countries/Minamoto.txt"
TAC="countries/Tachibana.txt"
FUJ="countries/Fujiwara.txt"
TAI="countries/Taira.txt"

KHA="countries/MongolKhanate.txt"
KHM="countries/Khmer.txt"
KOR="countries/Korea.txt"
LNA="countries/LanNa.txt"
LUA="countries/LuangPrabang.txt"
LXA="countries/LanXang.txt"
MAJ="countries/Majapahit.txt"
MCH="countries/Manchu.txt"
MKS="countries/Makassar.txt"
MLC="countries/Malacca.txt"
MNG="countries/Ming.txt"
MTR="countries/Mataram.txt"
OIR="countries/OiratHorde.txt"
PAT="countries/Pattani.txt"
PEG="countries/Pegu.txt"
QIN="countries/Qin.txt"
RYU="countries/Ryukyu.txt"
SST="countries/Shan.txt"
SUK="countries/Sukhothai.txt"
SUL="countries/Sulu.txt"
TAU="countries/Taungu.txt"
TIB="countries/Tibet.txt"
TOK="countries/Tonkin.txt"
VIE="countries/Vientiane.txt"
WUU="countries/Wu.txt"
XIA="countries/Xia.txt"

AHM="countries/Bihar.txt"
ASS="countries/Assam.txt"
BAH="countries/Deccan.txt"
BAL="countries/Baluchistan.txt"
BAS="countries/Ahmadnagar.txt"
BNG="countries/Bengal.txt"
BRR="countries/Berar.txt"
BHO="countries/Bhonsle.txt" 
BHU="countries/Bhutan.txt"
BIJ="countries/Bijapur.txt"
BND="countries/Bundelkhand.txt"
DLH="countries/Delhi.txt"
GAK="countries/Gakwar.txt"
GOC="countries/Golcanda.txt"
GDW="countries/Gondwana.txt" 
GUJ="countries/Gujarat.txt"
HYD="countries/Hyderabad.txt"
KRK="countries/Carnatic.txt"
KSH="countries/Kashmir.txt"
KHD="countries/Khandesh.txt"
KTH="countries/Ceylon.txt"
MAD="countries/Madurai.txt"
MAR="countries/Maharasthra.txt"
MLB="countries/Manipur.txt"
MLD="countries/Maldive.txt"
MLW="countries/Malwa.txt"
MUG="countries/Mughal.txt"
MYS="countries/Mysore.txt"
NIZ="countries/DevaBengal.txt"
NPL="countries/Nepal.txt"
ORI="countries/Orissa.txt"
ODH="countries/Oudh.txt"
PUN="countries/Punjab.txt"
RAJ="countries/Rajputna.txt"
SND="countries/Sind.txt"
TRV="countries/Travanacore.txt"
VIJ="countries/Vijaynagara.txt"

BAR="countries/Bar.txt"
HSA="countries/Hansa.txt"
SMO="countries/Smolensk.txt"
MUR="countries/Murom.txt"
NZH="countries/NizhnyNovgorod.txt"
KOJ="countries/Jerusalem.txt"
MSA="countries/Malaya.txt"
HIN="countries/Hindustan.txt"

### Vsemirna Vlast ###
#Scandavia
TEV="countries/teutonics.txt"
ICE="countries/Iceland.txt"
FTP="countries/finPeople.txt"
VIK="countries/vikings.txt"

#British Isles 
GBW="countries/Britaniawales.txt"
DUM="countries/domonia.txt"	
MEA="countries/Meath.txt"
MER="countries/Mercia.txt"
WSS="countries/wessex.txt"
STD="countries/stra.txt"
PIC="countries/picts.txt"
ESA="countries/eastAnglia.txt"
AEG="countries/angles.txt"
BLE="countries/belgae.txt"
ERT="countries/trino.txt"
ICC="countries/iceni.txt"
ORD="countries/ordovices.txt"
BIR="countries/brigantes.txt"
CEL="countries/caledoni.txt"
ELB="countries/elbani.txt"
NAG="countries/nagnatae.txt"
LON="countries/london.txt"
KNE="countries/kent.txt"
ATR="countries/atrebates.txt"
ELM="countries/elmet.txt"
DYF="countries/dyfed.txt"
CER="countries/ceredigion.txt"
POW="countries/powys.txt"
GWY="countries/gwynedd.txt"
RHE="countries/rheged.txt"
IRF="countries/Ireland2.txt"

#Iberia
BVR="countries/Barselona.txt"
ANE="countries/andora.txt"
VIS="countries/visigoths.txt"
SUE="countries/suevi.txt"
KUN="countries/cantabria.txt"
LEZ="countries/leon.txt"
VES="countries/vascones.txt"
ORC="countries/cordoba.txt"

#Italy
RMP="countries/Rome2.txt"
BLG="countries/bologna.txt"
MCA="countries/massaCarrara.txt"
ASI="countries/EmirateOfSicily.txt"
AUI="countries/aquita.txt"
EUN="countries/eu.txt"
LOM="countries/lombardy.txt"
SAN="countries/SanMarino.txt"
MOA="countries/monaco.txt"
KTS="countries/KingdomoftheTwoSicilies.txt"
MLT="countries/Malta.txt"
RME="countries/Rome.txt"

#Western Europe
EHF="countries/eastFrancia.txt"
LHT="countries/lotharingia.txt"
GRI="countries/germanEmpire.txt"
LIH="countries/lihten.txt"	
HFR="countries/franks.txt"
TLE="countries/toluse.txt"
VNA="countries/vandals.txt"
FRE="countries/frizi.txt"
RUG="countries/rugi.txt"
GHT="countries/goths.txt"
SLI="countries/silures.txt"
GLA="countries/gauls.txt"
BRM="countries/BremenCity.txt"
FRS="countries/Frisia.txt"
DDR="countries/GDR.txt"
NAZ="countries/NaziGermany.txt"
BEL="countries/Belgium.txt"
MST="countries/MecklenburgStrelitz.txt"
ERM="countries/Warmia.txt" 
EFR="countries/EastFrisia.txt"
LUB="countries/Luebeck.txt"
SLW="countries/Schleswig.txt"

#Central Europe
GMV="countries/gmoravia.txt"
CSL="countries/Czechoslovakia.txt"
CZC="countries/Czechnia.txt"
SLO="countries/Slovakia.txt"
AUT="countries/asturia.txt"
BLK="countries/blatnensko.txt"
SAT="countries/saxons.txt"
MCR="countries/macromani.txt"
GEP="countries/gepids.txt"
SLV="countries/Slovenia.txt"
DLB="countries/dulebi.txt"
BDR="countries/bodrichi.txt"
PMR="countries/pomoriani.txt"
VEL="countries/veleti.txt"
DRE="countries/dregovichi.txt" 
DEE="countries/devliani.txt" 
AVE="countries/avars.txt"
DAC="countries/daki.txt"
GEH="countries/geti.txt"
ROM="countries/Romania.txt"
HSL="countries/moraves.txt"
HUO="countries/hungary2.txt"

#Balkans
BIZ="countries/ByzantineEmpire2.txt"
AMA="countries/Macedonia2.txt"
ZET="countries/zeta.txt"
NEP="countries/neopatria.txt"
SRR="countries/serbia2.txt"
MLA="countries/moldavia2.txt"
ATE="countries/antes.txt"
RBU="countries/bulgaria2.txt"
BVD="countries/vidin.txt"
SLP="countries/SevenSlavicTribesAndSevers.txt"
VAL="countries/valkashin.txt"
TAR="countries/tarnovo.txt"
SIM="countries/simeon.txt"
KSL="countries/solun.txt"
MOM="countries/momchil.txt"
CHR="countries/hrelio.txt"
BLU="countries/belur.txt"
ATO="countries/aton.txt"
FIL="countries/philippopolis.txt"
ARE="countries/arta.txt"
GJI="countries/gjirokaster.txt"
MUZ="countries/muzakaj.txt"
KAS="countries/Kastriotit.txt"
LOL="countries/lezhe.txt"
BDD="countries/dobrodja.txt"
BGK="countries/bulgarianKhaganate.txt"
EPI="countries/epir.txt"
NII="countries/nicea.txt"
LIC="countries/latins.txt"
RAS="countries/raska.txt"
ODR="countries/traki.txt"
OST="countries/ostrogoths.txt"
BOO="countries/bosnia2.txt"
ECR="countries/croatia2.txt"
YGR="countries/YugoslavianRepublic.txt"
NDH="countries/IndependentStateOfCroatia.txt"
YGK="countries/YugoslavianKingdom.txt"
YUG="countries/Yugoslavia.txt"
MAC="countries/Macedonia.txt"
KOS="countries/Kosovo.txt"
WCR="countries/WhiteCroatia.txt"

#Russia
VLA="countries/suzdal.txt"
VKB="countries/volgabulgaria.txt"	
KIV="countries/kiev.txt"
KHZ="countries/khazars.txt"
BAO="countries/roxolani.txt"
BRS="countries/Belarus.txt"
SOV="countries/USSR.txt"
HNU="countries/huns.txt"
SRM="countries/sarmathians.txt"
BES="countries/bastarne.txt"
SIR="countries/siraces.txt"
LIP="countries/lithuania3.txt"
EES="countries/Estonia2.txt"
GVR="countries/galiciaVolinia.txt"
LAT="countries/Latvia.txt"
EST="countries/Estonia.txt"
CUM="countries/cumans.txt"
RDM="countries/radomichi.txt"
TIV="countries/tivertzi.txt"
PHU="countries/ProtoHungary.txt"
GBG="countries/greatBulgaria.txt"
THO="countries/theodoro.txt"
IME="countries/imereti.txt"
LIU="countries/lithuania2.txt"
PON="countries/poland2.txt"
RUU="countries/russia2.txt"

#Asia Minor
KRS="countries/kurdistan.txt"
GYA="countries/germiyans.txt"
ENT="countries/eretna.txt"
REP="countries/pervaneoglu.txt"
KSI="countries/kerasi.txt"
EDE="countries/edessa.txt"
TRC="countries/tripoli2.txt"
CYC="countries/cyprus2.txt"
OGZ="countries/rumSultanate.txt"
DAD="countries/danishmend.txt"
TRK="countries/Turkey.txt"
SEJ="countries/seljuks.txt"
TPE="countries/templars.txt"
CAP="countries/capadocia.txt"
CPR="countries/CyprioticRepublic2.txt"

#Near East
JER="countries/jer.txt"
ACA="countries/arabianCaliphate.txt"
ABB="countries/abbasid.txt"
PLM="countries/palmyra.txt"
AKS="countries/judea.txt"
ITU="countries/ituraea.txt"
NHA="countries/nabatea.txt"
OSR="countries/osroene.txt"
AAR="countries/armenia2.txt"
PNO="countries/pontus.txt"
GEA="countries/gerha.txt"
HIM="countries/hadramaut.txt"
QAT="countries/qataban.txt"
HEM="countries/himyar.txt"
SEB="countries/saba.txt"
LKH="countries/lakhmids.txt"
CIX="countries/xionites.txt"
CHU="countries/chubans.txt"
SAB="countries/Saudi Arabia.txt"
UAE="countries/UnitedArabEmirates.txt"
QTR="countries/Qatar.txt"
BHR="countries/Bahrain.txt"
JOR="countries/Jordan.txt"
PLS="countries/Palestine.txt"
ISR="countries/Israel.txt"
LEB="countries/Lebanon.txt"
KUW="countries/Kuwait.txt"
ADR="countries/NorthYemen.txt"
ADS="countries/PDRY.txt"
SUD="countries/Sudan.txt"
HMS="countries/HamasPalestine.txt"
OSS="countries/Ossetia.txt"
ABK="countries/Abkhazia.txt"
AZR="countries/Azerbaijan.txt"
IKH="countries/ilkhanate.txt"
SAL="countries/saladin.txt"

#Persia
KWZ="countries/khwarezm.txt"
THR="countries/thanesar.txt"
GHZ="countries/ghaznavid.txt"
GUP="countries/gupta.txt"
CYA="countries/cya.txt"
RHT="countries/rashtrakuta.txt"
AOS="countries/alans.txt"
KJU="countries/kangju.txt"
IRN="countries/Iran.txt"
PHT="countries/parthia.txt"

#Central Asia
TRM="countries/Turkmenistan.txt"
UZB="countries/Uzbekistan.txt"
AFG="countries/Afghanistan.txt"
TAJ="countries/Tajikistan.txt"
KYR="countries/Kyrgyztan.txt"
MGL="countries/Mongolia.txt"
PAH="countries/pahlavi.txt"
KUS="countries/kushan.txt"

#Far East
GUT="countries/gokturks.txt"
UYG="countries/uyghur.txt"
PEC="countries/pechenegs.txt"
SLY="countries/sila.txt"
GOG="countries/goguryeo.txt"
YEE="countries/taebong.txt"
SNG="countries/singapore.txt"
TNG="countries/tang.txt"
KHT="countries/khitan.txt"
JIN="countries/jin.txt"
SOG="countries/song.txt"
YUN="countries/yuan.txt"
FUN="countries/funan.txt"
XIO="countries/xiongnu.txt"
KHE="countries/han.txt"
MAH="countries/mahan.txt"
BJE="countries/baekje.txt"
DGY="countries/dongye.txt"
CAW="countries/wei.txt"
EWU="countries/easternWu.txt"
KSU="countries/shu.txt"
CJI="countries/jin2.txt"
HEP="countries/hepatites.txt"
RUR="countries/rurans.txt"
SUI="countries/sui.txt"
NZO="countries/norzo.txt"
DCH="countries/chenchina.txt"
NQI="countries/norqi.txt"
SHI="countries/Shilla.txt" 
PHI="countries/Philippines.txt"
SKO="countries/SouthKorea.txt"
NKO="countries/NorthKorea.txt"  
RCH="countries/PeoplesRepublicOfChina.txt"
CHN="countries/RepublicOfChina.txt"
MYA="countries/Myanmar.txt"
SVT="countries/SouthVietnam.txt"
VTN="countries/Vietnam.txt"
LAO="countries/Laos.txt"
CBD="countries/Cambodia.txt"
THA="countries/Thailand.txt"
MLY="countries/Malaysia.txt"
ETM="countries/EastTimor.txt"
IDO="countries/Indonesia.txt"
MCK="countries/Manchukuo.txt"
MGD="countries/Maguindanao.txt"
SUR="countries/Suriname.txt"

#India
SAK="countries/saka.txt"
SEV="countries/satavahana.txt"
CHH="countries/chera.txt"
PLV="countries/pandyas.txt"
LAM="countries/lamba.txt"
KAL="countries/kalinga.txt"
DAS="countries/dasarna.txt"
ABR="countries/abhira.txt"
YAU="countries/yaudheya.txt"
MLV="countries/malava.txt"
ARJ="countries/arjuna.txt"
MRU="countries/marunda.txt"
LCC="countries/licchavi.txt"
UTK="countries/utkala.txt"
SUH="countries/suhma.txt"
VAK="countries/vakataka.txt"
KAD="countries/kadamba.txt"
KLA="countries/kalabhras.txt"
SRI="countries/SriLanka.txt"
BGL="countries/Bangladesh.txt"
PAK="countries/Pakistan.txt"
IND="countries/India.txt"

#Japan
EMI="countries/emishi.txt"
YAM="countries/yamato.txt"
HOJ="countries/hojo.txt"
NBB="countries/nanbu.txt"
MGM="countries/mogami.txt"
DTE="countries/dates.txt"
TYT="countries/toyotomi.txt"
TUW="countries/tokugawa.txt"
ODA="countries/oda.txt"
CSO="countries/so.txt"
TAK="countries/takeda.txt"
OUC="countries/ouchi.txt"
SHN="countries/shoni.txt"
OTO="countries/otomo.txt"
ICJ="countries/ichijo.txt"
MIY="countries/miyoshi.txt"
TKI="countries/toki.txt"
ASK="countries/asuka.txt"
UES="countries/uesugi.txt"

#Africa
GAM="countries/gambia.txt"
GUB="countries/gvineabisau.txt"
LES="countries/lesoto.txt"
SWA="countries/swazilend.txt"
CEO="countries/carthage.txt"
MEP="countries/mapungubwe.txt"
ZEM="countries/zimbabwe2.txt"
MUT="countries/mutapa.txt"
MSU="countries/musumba.txt"
LBA="countries/luba.txt"
KTR="countries/kitara.txt"
ETO="countries/Ethiopia2.txt"
WGH="countries/wagadou.txt"
BEO="countries/Benin2.txt"
MAV="countries/mavretania.txt"
PGY="countries/aegipet.txt"
GHR="countries/moors.txt"
NBU="countries/nubia.txt"
AKE="countries/aksum.txt"
MLI="countries/Mali2.txt"
MRT="countries/Mauritania.txt"
SGL="countries/Senegal.txt"
VER="countries/CapeVerde.txt"
GUI="countries/Guinea.txt"
LEO="countries/SierraLeone.txt"
LBR="countries/Liberia.txt"
BFA="countries/BurkinaFaso.txt"
CDI="countries/Kotedivoar.txt"
GHA="countries/Ghana.txt"
TOG="countries/Togo.txt"
NGR="countries/Niger.txt"
CHD="countries/Chad.txt"
CMR="countries/Cameroon.txt"
NIG="countries/Nigeria.txt"
EQG="countries/EquatorialGuinea.txt"
GAB="countries/Gabon.txt"
DRC="countries/DemocraticRepublicoftheCongo.txt"
RCO="countries/RepublicoftheCongo.txt"
ANG="countries/Angola.txt"
NAM="countries/Namibia.txt"
SAF="countries/SouthAfrica.txt"
NTL="countries/Natalia.txt"
MAT="countries/Matabele.txt"
ZMB="countries/Zimbabwe.txt"
SMB="countries/Zambia.txt"
MOZ="countries/Mozambique.txt"
TAN="countries/Tanzania.txt"
ZNZ="countries/Zanzibar.txt"
KEN="countries/Kenya.txt"
RSO="countries/Somaliland.txt"
SOM="countries/Somalia.txt"
DJI="countries/Djibouti.txt"
ERI="countries/Eritrea.txt"
MDG="countries/Madagaskar.txt"
SEY="countries/Seychelles.txt"
MAU="countries/Mauritius.txt"
LIB="countries/Libya.txt"
VAA="countries/Transvaal.txt"
OFS="countries/OrangeFreeState.txt"
BOT="countries/Botsuana.txt"
CAR="countries/CentralAfricanRepublic.txt"
UGA="countries/Uganda.txt"
MWI="countries/Malawi.txt"
TNJ="countries/Tanganjika.txt"
RHO="countries/Rhodesia.txt"
OMD="countries/Omdurman.txt"
EGY="countries/Egypt.txt"
ARV="countries/almoravids.txt"
ZIR="countries/zirid.txt"
TUO="countries/Tunis.txt"
ALF="countries/Algeria.txt"

#America
APA="countries/Apache.txt"
SUC="countries/confederacy.txt"
MAP="countries/Mapuche.txt"
TWA="countries/Tiwanaku.txt"
CHC="countries/Chancay.txt"
ICA="countries/Ica.txt"
GAC="countries/Guanca.txt"
QTO="countries/Quito.txt"
CBC="countries/Chibcha.txt"
TAE="countries/Tairona.txt"
CAL="countries/Calusa.txt"
TMC="countries/Timucua.txt"
PWT="countries/Potawatomi.txt"
SUS="countries/Susquehanna.txt"
CHO="countries/Choctaw.txt"
CKS="countries/Chickasaw.txt"
CAD="countries/Caddo.txt"
QUI="countries/Quiche.txt"
OJI="countries/Ojibwa.txt"
MOH="countries/Mohican.txt"
SIO="countries/Sioux.txt"
MIA="countries/Miami.txt"
ILL="countries/Illinois.txt"
OSA="countries/Osage.txt"
WIC="countries/Wichita.txt"
CAK="countries/Cakchiquel.txt"
NAO="countries/Navajo.txt"
MOJ="countries/Mojave.txt"
YKT="countries/Yokuts.txt"
PUT="countries/Putun.txt"
COK="countries/Chinook.txt"
TOT="countries/Totonacapan.txt"
MET="countries/Metztitlan.txt"
MIX="countries/Mixtec.txt"
TER="countries/Tarascan.txt"
PEO="countries/Pomo.txt"
CEM="countries/Comanche.txt"
ERA="countries/Erie.txt"
TLP="countries/Tlacopan.txt"
TXC="countries/Texcoco.txt"
TLX="countries/Tlaxcala.txt"
BOL="countries/Bolivia.txt"
BAE="countries/Barbados.txt"
BHM="countries/Bahamas.txt"
BLZ="countries/Belize.txt"
COS="countries/CostaRica.txt"
CUB="countries/Cuba.txt"
DMC="countries/Dominica.txt"
DOM="countries/DominicanRepublic.txt"
ECU="countries/Ecuador.txt"
ELS="countries/ElSalvador.txt"
GUA="countries/Guatemala.txt"
GYN="countries/Guyana.txt"
HON="countries/Honduras.txt"
TRN="countries/TrinidadAndTobago.txt"
URU="countries/Uruguay.txt"
JMC="countries/Jamaica.txt"
NIC="countries/Nicaragua.txt"
PAN="countries/Panama.txt"
STK="countries/StKittsAndNevis.txt"
STL="countries/StLucia.txt"
ANT="countries/AntiguaAndBarbuda.txt"
ARG="countries/Argentina.txt"
TEX="countries/Texas.txt"
GRN="countries/Grenada.txt"
STV="countries/SaintVincentAndTheGrenadines.txt"
HAW="countries/Hawaii.txt"

#Oceania
ABE="countries/aborigenes.txt"
ARR="countries/arrente.txt"
AUS="countries/Australia.txt"
CIS="countries/cookIslands.txt"
COM="countries/Comoros.txt"
FIJ="countries/Fiji.txt"
KHK="countries/kokatha.txt"
KIR="countries/Kiribati.txt"
KOI="countries/kamilaroi.txt"
MIC="countries/micronezia.txt"
NAU="countries/Nauru.txt"
NZE="countries/NewZealand.txt"
PNG="countries/PapuaNewGuinea.txt"
SAM="countries/Samoa.txt"
SAO="countries/Saotome.txt"
SOL="countries/SolomonIslands.txt"
TGO="countries/Tonga.txt"
TUV="countries/Tuvalu.txt"
VAN="countries/Vanuatu.txt"
WIR="countries/wiradjuri.txt"
WKY="countries/wakaya.txt"